
SO ./textures/bouzelouf.xpm
EA ./textures/bouzelouf.xpm
C 225,0,255

NO ./textures/bouzelouf.xpm
F 220,100,0
WE ./textures/bouzelouf.xpm






1111111111111111111111
1DDDDDDDDDDDDDDDDDDDD1
1DE00000000000000000D1
1DDDDDDDDDDDDDDDDDDDD1
1111111111111111111111