





SO           ./textures/so/malebrun.xpm
EA ./textures/ea/malebrun.xpm
C 225,0,255

NO                ./textures/no/malebrun.xpm
F 200,100,0



WE ./textures/we/malebrun.xpm





        1111111111111111111111111
        1000000000110000000000001
        1011000001110000000000001
        1001000000D00000000000001
111111111011000001110000000000001
100000000011000001110111111111111
11110111111101011100000010001
111101111111D10111010100D0001
11000000110101011100000010001
10000000000000001100000010001
1000000000000000DD01010010001
11000001110101011111011110N0011
11110111 1110101 101111010001
1111D111 1111111 111111111111
   101
   111