SO ./textures/jonpork.xpm
EA ./textures/jonpork.xpm
C 225,0,255

NO ./textures/jonpork.xpm
F 220,100,0
WE ./textures/uigdwug.xpm






11111111111111111111111
1DDDDDDDDDDDDDDDDDDDDD1
1DDDDDDDDDDDDDDDDDDDDD1
1DDDDDDDDDDDDDDDDDDDDD1
1DDDDDDDDDDNDDDDDDDDDD1
1DDDDDDDDDDDDDDDDDDDDD1
1DDDDDDDDDDDDDDDDDDDDD1
1DDDDDDDDDDDDDDDDDDDDD1
1DDDDDDDDDDDDDDDDDDDDD1
11111111111111111111111